#     # ######  #     #       #    ### 
#     # #     # #     #      # #    #  
#     # #     # #     #     #   #   #  
#     # ######  #     #    #     #  #  
 #   #  #   #   #     #    #######  #  
  # #   #    #  #     #    #     #  #  
   #    #     #  #####     #     # ### 
                                       
