%%%%%%%%%%%%%%%%%%%%%%%%%%%%%%%%%%%%%%%%%%
%........................................%
%.%.....%.%%%%%%..%.....%.......%....%%%.%
%.%.....%.%.....%.%.....%......%.%....%..%
%.%.....%.%.....%.%.....%..P..%...%...%..%
%.%.....%.%%%%%%..%.....%....%.....%..%..%
%..%...%..%...%...%.....%....%%%%%%%..%..%
%...%.%...%....%..%.....%....%.....%..%..%
%....%....%.....%..%%%%%.....%.....%.%%%.%
%........................................%
%%%%%%%%%%%%%%%%%%%%%%%%%%%%%%%%%%%%%%%%%%